Абаза - abaza
Абакан - abakan
Абдулино - abdulino
Абинск - abinsk
Агидель - Agidel
Агрыз - Agryz
Адыгейск - Adygeysk
Азнакаево - Aznakaevo
Азов - Azov
Ак-Довурак - Ak-Dovurak
Аксай - Aksay
Алагир - Alagir
Алапаевск - Alapaevsk
Алатырь - Alatyr
Алдан - Aldan
Алейск - Aleysk
Александров - Aleksandrov
Александровск - Aleksandrovsk
Александровск-Сахалинский - Aleksandrovsk-Sakhalinskiy
Алексеевка - Alekseevka
Алексин - Aleksin
Алзамай - Alzamay
Алупка - Alupka
Алушта - Alushta
Альметьевск - Almetyevsk
Амурск - Amursk
Анадырь - Anadyr 
Анапа - Anapa
Ангарск - Angarsk
Андреаполь - Andreapol
Анжеро-Судженск - Anzhero-Sudzhensk
Анива - aniva
Апатиты - apatity
Апрелевка - aprelevka
Апшеронск - apsheronsk
Арамиль - aramil
Аргун - argun
Ардатов - ardatov
Ардон - ardon
Арзамас - arzamas
Аркадак - arkadak
Армавир - armavir
Армянск - armyansk
Арсеньев - arsenyev
Арск - arsk
Артём - artyom
Артёмовск - artyomovsk
Артёмовский - artyomovsky
Архангельск - arkhangelsk
Асбест - asbest
Асино - asino
Астрахань - astrakhan
Аткарск - atkarsk
Ахтубинск - akhtubinsk
Ачинск - achinsk
Аша - asha
Бабаево - babaevo
Бабушкин - babushkin
Бавлы - bavly
Багратионовск - bagrationovsk
Байкальск - baikalsk
Баймак - baymak
Бакал - bakal
Баксан - baksan
Балабаново - balabanovo
Балаково - balakovo
Балахна - balakhna
Балашиха - balashikha
Балашов - balashov
Балей - baley
Балтийск - baltijsk
Барабинск - barabinsk
Барнаул - barnaul
Барыш - barysh
Батайск - bataysk
Бахчисарай - bakhchisaray
Бежецк - bezhetsk
Белая Калитва - belaya-kalitva
Белая Холуница - belaya-kholunitsa
Белгород - belgorod
Белебей - belebei
Белёв - belev
Белинский - belinsky
Белово - belovo
Белогорск - belogorsk
Белогорск - belozersk
Белозерск - belokurikha
Белокуриха - belomorsk
Беломорск - beloozyorsky
Белоозёрский - beloretsk
Белорецк - belorechensk
Белореченск - belousovo
Белоусово - beloyarsky
Белоярский - bely
Белый - berdsk
Бердск - berezniki
Березники - berezovsky
Берёзовский - beslan
Берёзовский - biysk
Беслан - bikin
Бийск - bilibino
Бикин - birobidzhan
Билибино - birsk
Биробиджан - biryusinsk
Бирск - biryuch
Бирюсинск - blagoveshchensk
Бирюч - blagodatny
Благовещенск - bobrov
Благовещенск - bogdanovich
Благодарный - bogoroditsk
Бобров - bogorodsk
Богданович - bogotol
Богородицк - boguchar
Богородск - bodajbo
Боготол - boksitogorsk
Богучар - bolgar
Бодайбо - bologoe
Бокситогорск - bolotnoe
Болгар - bolokhovo
Бологое - bolkhov
Болотное - bolshoy-kamen
Болохово - bor
Болхов - borzya
Большой Камень - borisoglebsk
Бор - borovichi
Борзя - borovsk
Борисоглебск - borodino
Боровичи - bratsk
Боровск - bronnitsy
Бородино - bryansk
Братск - bugulma
Бронницы - buguruslan
Брянск - budyonnovsk
Бугульма - buzuluk
Бугуруслан - buinsk
Будённовск - buy
Бузулук - buynaksk
Буинск - buturlinovka
Буй - valdai
Буйнакск - valuiki
Бутурлиновка - velizh
Валдай - velikie-luki
Валуйки - veliky-novgorod
Велиж - veliky-ustyug
Великие Луки - velsk
Великий Новгород - venyov
Великий Устюг - vereshtshagino
Вельск - vereya
Венёв - verkhneuralsk
Верещагино - verkhniy-tagil
Верея - verkhniy-ufaley
Верхнеуральск - verkhnyaya-pyshma
Верхний Тагил - verkhnyaya-salda
Верхний Уфалей - verkhnyaya-tura
Верхняя Пышма - verkhoturye
Верхняя Салда - verkhoyansk
Верхняя Тура - vesegonsk
Верхотурье - vetluga
Верхоянск - vidnoye
Весьегонск - vilyuysk
Ветлуга - viluchinsk
Видное - vikhorovka
Вилюйск - vichuga
Вилючинск - vladivostok
Вихоревка - vladikavkaz
Вичуга - vladimir
Владивосток - volgograd
Владикавказ - volgodonsk
Владимир - volgorechensk
Волгоград - volzhsk
Волгодонск - volzhskiy
Волгореченск - vologda
Волжск - volodarsk
Волжский - volokolamsk
Вологда - volosovo
Володарск - volkhov
Волоколамск - volchansk
Волосово - volsk
Волхов - vorkuta
Волчанск - voronezh
Вольск - vorsma
Воркута - voskresensk
Воронеж - votkinsk
Ворсма - vsevolozhsk
Воскресенск - vuktyl
Воткинск - vyborg
Всеволожск - vykhsa
Вуктыл - vysokovsk
Выборг - vysok
Выкса - vytegra
Высоковск - vyshniy-volochek
Высоцк - vyazemskiy
Вытегра - vyazniki
Вышний Волочёк - vyazma
Вяземский - vyatskie-polyany
Вязники - gavrilov-posad
Вязьма - gavrilov-yam
Вятские Поляны - gagarin
Гаврилов Посад - gadzhievo
Гаврилов-Ям - gay
Гагарин - galich
Гаджиево - gatchina
Гай - gvardeysk
Галич - gdov
Гатчина - gelendzhik
Гвардейск - georgievsk
Гдов - glazov
Геленджик - golitsyno
Георгиевск - gorbatov
Глазов - gorno-altaysk
Голицыно - gornozavodsk
Горбатов - gornyak
Горно-Алтайск - gorodets
Горнозаводск - gorodishche
Горняк - gorodovikovsk
Городец - gorokhovets
Городище - goryachiy-klyuch
Городовиковск - grayvoron
Гороховец - gremyachinsk
Горячий Ключ - grozny
Грайворон - gryazi
Гремячинск - gryazovets
Грозный - gubakha
Грязи - gubkin
Грязовец - gubkinskiy
Губаха - gudermes
Губкин - gukovo
Губкинский - gulkewichi
Гудермес - guryevsk
Гуково - gusev
Гулькевичи - gusinoozersk
Гурьевск - guryevsk
Гурьевск - guryevsk
Гусев - gusev
Гусиноозёрск - gusinoozyorsk
Гусь-Хрустальный - gus-khrustalny
Давлеканово - davlekanovo
Дагестанские Огни - dagestanskie-ogni
Далматово - dalmatovo
Дальнегорск - dalnegorsk
Дальнереченск - dalnerechensk
Данилов - danilov
Данков - dankov
Дегтярск - degtyarsk
Дедовск - dedovsk
Демидов - demidov
Дербент - derbent
Десногорск - desnogorsk
Джанкой - dzhankoy
Дзержинск - dzerzhinsk
Дзержинский - dzerzhinsky
Дивногорск - divnogorsk
Дигора - digora
Димитровград - dimitrovgrad
Дмитриев - dmitriev
Дмитров - dmitrov
Дмитровск - dmitrovsk
Дно - dno
Добрянка - dobryanka
Долгопрудный - dolgoprudny
Долинск - dolinsk
Домодедово - domodedovo
Донецк - donetsk
Донской - donskoy
Дорогобуж - dorogobuzh
Дрезна - drezna
Дубна - dubna
Дубовка - dubovka
Дудинка - dudinka
Духовщина - dukhovshchina
Дюртюли - dyurtyuli
Дятьково - dyatkovo
Евпатория - evpatoria
Егорьевск - egoryevsk
Ейск - yeisk
Екатеринбург - ekaterinburg
Елабуга - elabuga
Елец - yelets
Елизово - elizovo
Ельня - elnya
Еманжелинск - emanzhelinsk
Емва - yemva
Енисейск - eniseysk
Ермолино - ermolino
Ершов - ershov
Ессентуки - essentuki
Ефремов - yefremov
Железноводск - zheleznovodsk
Железногорск - zheleznogorsk
Железногорск - zheleznogorsk
Железногорск-Илимский - zheleznogorsk-ilimsky
Жердевка - zherdevka
Жигулёвск - zhigulyovsk
Жиздра - zhizdra
Жирновск - zhirnovsk
Жуков - zhukov
Жуковка - zhukovka
Жуковский - zhukovsky
Завитинск - zavitinsk
Заводоуковск - zavodoukovsk
Заволжск - zavolzhsk
Заволжье - zavolzhye
Задонск - zadonsk
Заинск - zainsk
Закаменск - zakamensk
Заозёрный - zaozerny
Заозёрск - zaozersk
Западная Двина - zapadnaya-dvina
Заполярный - zapolyarny
Зарайск - zaraysk
Заречный - zarechny
Заречный - zarechny
Заринск - zarinsk
Звенигово - zvenigovo
Звенигород - zvenigorod
Зверево - zverevo
Зеленогорск - zelenogorsk
Зеленоградск - zelenogradsk
Зеленодольск - zelenodolsk
Зеленокумск - zelenokumsk
Зерноград - zernograd
Зея - zeya
Зима - zima
Златоуст - zlatoust
Злынка - zlynka
Змеиногорск - zmeinogorsk
Знаменск - znamen
Зубцов - zubtsov
Зуевка - zuevka
Ивангород - ivangorod
Иваново - ivanovo
Ивантеевка - ivanteevka
Ивдель - ivdel
Игарка - igarka
Ижевск - izhevsk
Избербаш - izberbash
Изобильный - izobilny
Иланский - ilansky
Инза - inza
Иннополис - innopolis
Инсар - insar
Инта - inta
Ипатово - ipatovo
Ирбит - irbit
Иркутск - irkutsk
Исилькуль - isilkul
Искитим - iskitim
Истра - istra
Ишим - ishim
Ишимбай - ishimbay
Йошкар-Ола - yoshkar-ola
Кадников - kadnikov
Казань - kazan
Калач - kalach
Калач-на-Дону - kalach-na-donu
Калачинск - kalachinsk
Калининград - kaliningrad
Калининск - kalininsk
Калтан - kaltan
Калуга - kaluga
Калязин - kalyazin
Камбарка - kambarka
Каменка - kamenka
Каменногорск - kamennogorsk
Каменск-Уральский - kamensk-uralsky
Каменск-Шахтинский - kamensk-shakhtinsky
Камень-на-Оби - kamen-na-obi
Камешково - kameshkovo
Камызяк - kamyzyak
Камышин - kamyshin
Камышлов - kamyshlov
Канаш - kanash
Кандалакша - kandalaksha
Канск - kansk
Карабаново - karabanovo
Карабаш - karabash
Карабулак - karabulak
Карасук - karasuk
Карачаевск - karachayevsk
Карачев - karachev
Каргат - kargat
Каргополь - kargopol
Карпинск - karpinsk
Карталы - kartaly
Касимов - kasimov
Касли - kasli
Каспийск - kaspiysk
Катав-Ивановск - katav-ivanovsk
Катайск - kataysk
Качканар - kachkanar
Кашин - kashin
Кашира - kashira
Кедровый - kedrov
Кемерово - kemerovo
Кемь - kem
Керчь - kerch
Кизел - kisel
Кизилюрт - kizilyurt
Кизляр - kizlyar
Кимовск - kimovsk
Кимры - kimry
Кингисепп - kingisepp
Кинель - kinel
Кинешма - kineshma
Киреевск - kireevsk
Киренск - kirensk
Киржач - kirzhach
Кириллов - kirillov
Кириши - kirish
Киров - kirov
Киров - kirov
Кировград - kirovgrad
Кирово-Чепецк - kirovo-chepetsk
Кировск - kirovsk
Кировск - kirovsk
Кирс - kirs
Кирсанов - kirsanov
Киселёвск - kiselevsk
Кисловодск - kislovodsk
Клин - klin
Клинцы - klintsy
Княгинино - knyaginino
Ковдор - kovdor
Ковров - kovrov
Ковылкино - kovylkino
Когалым - kogalym
Кодинск - kodinsk
Козельск - kozelsk
Козловка - kozlova
Козьмодемьянск - kozmodemyansk
Кола - kola
Кологрив - kologriv
Коломна - kolomna
Колпашево - kolpashevo
Кольчугино - kolchugino
Коммунар - kommunar
Комсомольск - komsomolsk
Комсомольск-на-Амуре - komsomolsk-na-amure
Конаково - konakovo
Кондопога - kondopoga
Кондрово - kondrovo
Константиновск - konstantinovsk
Копейск - kopeysk
Кораблино - korablin
Кореновск - korenovsk
Коркино - korkino
Королёв - korolev
Короча - korocha
Корсаков - korsakov
Коряжма - koryazhma
Костерёво - kosterovo
Костомукша - kostomuksha
Кострома - kostroma
Котельники - kotelniki
Котельниково - kotelnikovo
Котельнич - kotelnich
Котлас - kotlas
Котово - kotovo
Котовск - kotovsk
Кохма - kukhma
Красавино - krasavino
Красноармейск - krasnoarmeysk
Красноармейск - krasnoarmeysk
Красновишерск - krasnovishersk
Красногорск - krasnogorsk
Краснодар - krasnodar
Краснозаводск - krasnozavodsk
Краснознаменск - krasnoznamensk
Краснознаменск - krasnoznamensk
Краснокаменск - krasnokamensk
Краснокамск - krasnokamsk
Красноперекопск - krasnoperikovsk
Краснослободск - krasnoslobodsk
Краснослободск - krasnoslobodsk
Краснотурьинск - krasnoturyinsk
Красноуральск - krasnouralsk
Красноуфимск - krasnoufimsk
Красноярск - krasnoyarsk
Красный Кут - krasny-kut
Красный Сулин - krasny-sulin
Красный Холм - krasny-kholm
Кремёнки - kremyonki
Кропоткин - kropotkin
Крымск - krymsk
Кстово - kstovo
Кубинка - kubinka
Кувандык - kuvandyk
Кувшиново - kuvshinovo
Кудрово - kudrovo
Кудымкар - kudymkar
Кузнецк - kuznetsk
Куйбышев - kuibyshev
Кукмор - kukmor
Кулебаки - kulebaki
Кумертау - kumeratau
Кунгур - kungur
Купино - kupino
Курган - kurgan
Курганинск - kurganinsk
Курильск - kurilsk
Курлово - kurlovo
Куровское - kurovskoye
Курск - kursk
Куртамыш - kurtamysh
Курчалой - kurchaloy
Курчатов - kurchatov
Куса - kusa
Кушва - kushva
Кызыл - kyzyl
Кыштым - kyshtym
Кяхта - kyakhta
Лабинск - labinsk
Лабытнанги - labytnangi
Лагань - lagan
Ладушкин - ladushkin
Лаишево - laishevo
Лакинск - lakinsk
Лангепас - langeps
Лахденпохья - lahdenpohya
Лебедянь - lebedyan
Лениногорск - leninogorsk
Ленинск - leninsk
Ленинск-Кузнецкий - leninsk-kuznetsky
Ленск - lensk
Лермонтов - lermontov
Лесной - lesnoy
Лесозаводск - lesozavodsk
Лесосибирск - lesosibirsk
Ливны - livny
Ликино-Дулёво - likino-dulyovo
Липецк - lipeck
Липки - lipki
Лиски - liski
Лихославль - likhoslavl
Лобня - lobnya
Лодейное Поле - lodeynoye-pole
Лосино-Петровский - losino-petrovsky
Луга - luga
Луза - luza
Лукоянов - lukoyanov
Луховицы - luhovitsy
Лысково - lyskovo
Лысьва - lysva
Лыткарино - lytkarino
Льгов - lygov
Любань - lyuban
Люберцы - lyubertsy
Любим - lyubim
Людиново - lyudinovo
Лянтор - lyantor
Магадан - magadan
Магас - magas
Магнитогорск - magnitogorsk
Майкоп - maykop
Майский - maysky
Макаров - makarov
Макарьев - makaryev
Макушино - makushino
Малая Вишера - malaya-vishera
Малгобек - malgobek
Малмыж - malmyzh
Малоархангельск - maloarkhangelsk
Малоярославец - maloyaroslavets
Мамадыш - mamadysh
Мамоново - mamonovo
Мантурово - manturovo
Мариинск - mariinsk
Мариинский Посад - mariinskiy-posad
Маркс - marks
Махачкала - makhachkala
Мглин - mglin
Мегион - megion
Медвежьегорск - medvezhyegorsk
Медногорск - mednogorsk
Медынь - medyn
Межгорье - mezhgorye
Междуреченск - mezhdurechensk
Мезень - mezen
Меленки - melenki
Мелеуз - meleuz
Менделеевск - mendeleyevsk
Мензелинск - menzelinsk
Мещовск - meshchovsk
Миасс - miass
Микунь - mikunya
Миллерово - millerovo
Минеральные Воды - mineralnye-vody
Минусинск - minusinsk
Миньяр - minyar
Мирный - mirny
Мирный - mirny
Михайлов - mikhaylov
Михайловка - mikhaylovka
Михайловск - mikhaylovsk
Михайловск - mikhaylovsk
Мичуринск - michurinsk
Могоча - mogocha
Можайск - mozhaysk
Можга - mozhga
Моздок - mozdok
Мончегорск - monchegorsk
Морозовск - morozovsk
Моршанск - morshansk
Мосальск - mosalsk
Москва - moskva
Муравленко - muravlenko
Мураши - murashi
Мурино - murino
Мурманск - murmansk
Муром - murom
Мценск - mtsensk
Мыски - myski
Мытищи - mytishchi
Мышкин - myshkin
Набережные Челны - naberezhnye-chelny
Навашино - navashino
Наволоки - navoloki
Надым - nadym
Назарово - nazarovo
Назрань - nazran
Называевск - nazyvaevsk
Нальчик - nalchik
Нариманов - narimanov
Наро-Фоминск - naro-fominsk
Нарткала - nartkala
Нарьян-Мар - naryan-mar
Находка - nakhodka
Невель - nevel
Невельск - nevelsk
Невинномысск - nevinnomyssk
Невьянск - nevyansk
Нелидово - nelidovo
Неман - neman
Нерехта - nerehta
Нерчинск - nerchinsk
Нерюнгри - neryungri
Нестеров - nesterov
Нефтегорск - neftegorsk
Нефтекамск - neftekamsk
Нефтекумск - neftekumsk
Нефтеюганск - nefteyugansk
Нея - neya
Нижневартовск - nizhnevartovsk
Нижнекамск - nizhnekamsk
Нижнеудинск - nizhneudinsk
Нижние Серги - nizhnie-sergi
Нижний Ломов - nizhniy-lomov
Нижний Новгород - nizhniy-novgorod
Нижний Тагил - nizhniy-tagil
Нижняя Салда - nizhnaya-salda
Нижняя Тура - nizhnaya-tura
Николаевск - nikolaevsk
Николаевск-на-Амуре - nikolaevsk-na-amure
Никольск - nikolsk
Никольск - nikolsk
Никольское - nikolskoe
Новая Ладога - novaya-ladoga
Новая Ляля - novaya-lyalya
Новоалександровск - novoaleksandrovsk
Новоалтайск - novoaltaysk
Новоаннинский - novoanninskiy
Нововоронеж - novovoronezh
Новодвинск - novodvinsk
Новозыбков - novozybkov
Новокубанск - novokubansk
Новокузнецк - novokuznetsk
Новокуйбышевск - novokuybyshevsk
Новомичуринск - novomichurinsk
Новомосковск - novomoskovsk
Новопавловск - novopavlovsk
Новоржев - novorzhev
Новороссийск - novorossiysk
Новосибирск - novosibirsk
Новосиль - novosil
Новосокольники - novosokolniki
Новотроицк - novotroitsk
Новоузенск - novouzensk
Новоульяновск - novoulyanovsk
Новоуральск - novouralsk
Новохопёрск - novohopersk
Новочебоксарск - novocheboksarsk
Новочеркасск - novocherkassk
Новошахтинск - novoshahtinsk
Новый Оскол - novyy-oskol
Новый Уренгой - novyy-urengoy
Ногинск - noginsk
Нолинск - nolinsk
Норильск - norilsk
Ноябрьск - noyabrsk
Нурлат - nurlat
Нытва - nytva
Нюрба - nyurba
Нягань - nyagan
Нязепетровск - nyazepetrovsk
Няндома - nyandoma
Облучье - obluchye
Обнинск - obninsk
Обоянь - oboyan
Обь - ob
Одинцово - odintsovo
Озёрск - ozersk
Озёрск - ozersk
Озёры - ozery
Октябрьск - oktyabrsk
Октябрьский - oktyabrskiy
Окуловка - okulovka
Олёкминск - oleyminsk
Оленегорск - olenegorsk
Олонец - olonets
Омск - omsk
Омутнинск - omutninsk
Онега - onega
Опочка - opochka
Орёл - orel
Оренбург - orenburg
Орехово-Зуево - orekhovo-zuevo
Орлов - orlov
Орск - orsk
Оса - osa
Осинники - osinniki
Осташков - ostashkov
Остров - ostrov
Островной - ostrovnoy
Острогожск - ostrogozhsk
Отрадное - otradnoe
Отрадный - otradnyy
Оха - okha
Оханск - ohansk
Очёр - ocher
Павлово - pavlovo
Павловск - pavlovsk
Павловский Посад - pavlovskiy-posad
Палласовка - pallasovka
Партизанск - partizansk
Певек - pevek
Пенза - penza
Первомайск - pervomaysk
Первоуральск - pervouralsk
Перевоз - perevoz
Пересвет - peresvet
Переславль-Залесский - pereslavl-zalesskiy
Пермь - perm
Пестово - pestovo
Петров Вал - petrov-val
Петровск - petrovsk
Петровск-Забайкальский - petrovsk-zabaykalskiy
Петрозаводск - petrozavodsk
Петропавловск-Камчатский - petropavlovsk-kamchatskiy
Петухово - petuhovo
Петушки - petushki
Печора - pechora
Печоры - pechory
Пикалёво - pikalyevo
Пионерский - pionerskiy
Питкяранта - pitkaryana
Плавск - plavsk
Пласт - plast
Плёс - plyos
Поворино - povorino
Подольск - podolsk
Подпорожье - podporye
Покачи - pokachi
Покров - pokrov
Покровск - pokrovsk
Полевской - polevskiy
Полесск - polessk
Полысаево - polysaevsk
Полярные Зори - polyarnye-zori
Полярный - polyarnyy
Поронайск - poronaysk
Порхов - porhov
Похвистнево - pohvistnevo
Почеп - pochep
Починок - pochinok
Пошехонье - poshehonye
Правдинск - pravdinsk
Приволжск - privolzhsk
Приморск - primorsk
Приморск - primorsk
Приморско-Ахтарск - primorsko-ahtarsk
Приозерск - priozersk
Прокопьевск - prokopevsk
Пролетарск - proletarsk
Протвино - protvino
Прохладный - prohladnyy
Псков - pskov
Пугачёв - pugachev
Пудож - pudoj
Пустошка - pustoshka
Пучеж - puchezh
Пушкино - pushkino
Пущино - pushchino
Пыталово - pytalovo
Пыть-Ях - pyt-yah
Пятигорск - pyatigorsk
Радужный - raduzhnyy
Радужный - raduzhnyy
Райчихинск - raychikhinsk
Раменское - ramenskoye
Рассказово - rasskazovo
Ревда - revda
Реж - rezh
Реутов - reutov
Ржев - rjev
Родники - rodniki
Рославль - roslavl
Россошь - rossosh
Ростов - rostov
Ростов-на-Дону - rostov-na-donu
Рошаль - roshal
Ртищево - rtischevo
Рубцовск - rubtsovsk
Рудня - rudnya
Руза - ruza
Рузаевка - ruzayevka
Рыбинск - rybinsk
Рыбное - rybnoe
Рыльск - rylsk
Ряжск - ryazsk
Рязань - ryazan
Саки - saki
Салават - salavat
Салаир - salaire
Салехард - salehard
Сальск - salsk
Самара - samara
Санкт-Петербург - sankt-peterburg
Саранск - saransk
Сарапул - sarapul
Саратов - saratov
Саров - sarov
Сасово - sasovo
Сатка - satka
Сафоново - safonovo
Саяногорск - saynogorsk
Саянск - sayansk
Светлогорск - svetlogorsk
Светлоград - svetlograd
Светлый - svetly
Светогорск - svetogorsk
Свирск - svirsk
Свободный - svobodny
Себеж - sebesh
Севастополь - sevastopol
Северо-Курильск - severo-kurilsk
Северобайкальск - severobaykalsk
Северодвинск - severodvinsk
Североморск - severomorsk
Североуральск - severouralsk
Северск - seversk
Севск - sevsk
Сегежа - segezha
Сельцо - seltso
Семёнов - semyonov
Семикаракорск - semikarakorsk
Семилуки - semiluki
Сенгилей - sengiley
Серафимович - serafimovich
Сергач - sergach
Сергиев Посад - sergiyev-posad
Сердобск - serdobsk
Серов - serov
Серпухов - serpukhov
Сертолово - sertolovo
Сибай - sibay
Сим - sim
Симферополь - simferopol
Сковородино - skovorodino
Скопин - skopin
Славгород - slavgorod
Славск - slavsk
Славянск-на-Кубани - slavyansk-na-kubani
Сланцы - slantsy
Слободской - slobodskoy
Слюдянка - slyudyanka
Смоленск - smolensk
Снежинск - snezhinsk
Снежногорск - snezhnogorsk
Собинка - sobinka
Советск - sovetsk
Советск - sovetsk
Советск - sovetsk
Советская Гавань - sovetskaya-gavani
Советский - sovetskiy
Сокол - sokol
Солигалич - soligalich
Соликамск - solikamsk
Солнечногорск - solnechnogorsk
Соль-Илецк - sol-iletsk
Сольвычегодск - solvychegodsk
Сольцы - soltsy
Сорочинск - sorochinsk
Сорск - sorsk
Сортавала - sortavala
Сосенский - sosensky
Сосновка - sosnovka
Сосновоборск - sosnovoborsk
Сосновый Бор - sosnovy-bor
Сосногорск - sosnogorsk
Сочи - sochi
Спас-Деменск - spas-demensky
Спас-Клепики - spas-klepiki
Спасск - spassk
Спасск-Дальний - spassk-dalniy
Спасск-Рязанский - spassk-ryazanskiy
Среднеколымск - srednekolymsk
Среднеуральск - sredneuralsk
Сретенск - sretensk
Ставрополь - stavropol
Старая Купавна - staraya-kupavna
Старая Русса - staraya-russa
Старица - staritsa
Стародуб - starodub
Старый Крым - stary-krym
Старый Оскол - stary-oskol
Стерлитамак - sterlitamak
Стрежевой - strezhvoy
Строитель - stroitel
Струнино - strunino
Ступино - stupino
Суворов - suvorov
Судак - sudak
Суджа - suzh
Судогда - sudgoda
Суздаль - suzdal
Сунжа - sunzha
Суоярви - suoyarvi
Сураж - surazh
Сургут - surgut
Суровикино - surovikino
Сурск - sursk
Сусуман - susuman
Сухиничи - sukhinichi
Сухой Лог - sukhoy-log
Сызрань - syzran
Сыктывкар - syktyvkar
Сысерть - syssert
Сычёвка - sychevka
Сясьстрой - syasstroy
Тавда - tavda
Таганрог - taganrog
Тайга - taiga
Тайшет - taishat
Талдом - taldom
Талица - talitsa
Тамбов - tambov
Тара - tara
Тарко-Сале - tarko-sale
Таруса - tarusa
Татарск - tatarsk
Таштагол - tashtagal
Тверь - tver
Теберда - teberda
Тейково - teykovo
Темников - temnikov
Темрюк - temryuk
Терек - terek
Тетюши - tetyushi
Тимашёвск - timashovsk
Тихвин - tikhvin
Тихорецк - tikhoretsk
Тобольск - tobolsk
Тогучин - toguchin
Тольятти - tolyatti
Томари - tomari
Томмот - tommot
Томск - tomsk
Топки - topki
Торжок - torzhok
Торопец - toropets
Тосно - tosno
Тотьма - totma
Трёхгорный - tryokhgorny
Троицк - troitsk
Трубчевск - trubchevsk
Туапсе - tuapse
Туймазы - tuimazy
Тула - tula
Тулун - tulun
Туран - turan
Туринск - turinsk
Тутаев - tutaev
Тында - tynda
Тырныауз - tyrnyauz
Тюкалинск - tyukalinsk
Тюмень - tyumen
Уварово - uvarovo
Углегорск - uglegorsk
Углич - uglich
Удачный - udachny
Удомля - udomlya
Ужур - uzhur
Узловая - uzlovaya
Улан-Удэ - ulan-ude
Ульяновск - ulyanovsk
Унеча - unetcha
Урай - urai
Урень - uren
Уржум - urzhum
Урус-Мартан - urus-martan
Урюпинск - uryupinsk
Усинск - usinsk
Усмань - usman
Усолье - usolye
Усолье-Сибирское - usolye-sibirskoye
Уссурийск - ussuriyisk
Усть-Джегута - ust-djeguta
Усть-Илимск - ust-ilimsk
Усть-Катав - ust-katav
Усть-Кут - ust-kut
Усть-Лабинск - ust-labinsk
Устюжна - ustyuzhna
Уфа - ufa
Ухта - uhta
Учалы - uchaly
Уяр - uyar
Фатеж - fatezh
Феодосия - feodosia
Фокино - fokino
Фокино - fokino
Фролово - frolovo
Фрязино - fryazino
Фурманов - furmanov
Хабаровск - khabarovsk
Хадыженск - khadyzhensk
Ханты-Мансийск - khanty-mansiysk
Харабали - kharabali
Харовск - kharovsk
Хасавюрт - khasavyurt
Хвалынск - khvalynsk
Хилок - khilok
Химки - khimki
Холм - kholm
Холмск - kholmsk
Хотьково - khotkovo
Цивильск - tsivilsk
Цимлянск - tsimlyansk
Циолковский - tsiolkovskiy
Чадан - chadan
Чайковский - chaykovskiy
Чапаевск - chapaevsk
Чаплыгин - chaplygin
Чебаркуль - chebarkul
Чебоксары - cheboksary
Чегем - chegem
Чекалин - chekalin
Челябинск - chelyabinsk
Чердынь - cherdyn
Черемхово - chereymkhovo
Черепаново - cherepanovo
Череповец - cherepovets
Черкесск - cherkessk
Чёрмоз - chermoz
Черноголовка - chernogolovka
Черногорск - chernogorsk
Чернушка - chernushka
Черняховск - chernyakhovsk
Чехов - chekhov
Чистополь - chistopol
Чита - chita
Чкаловск - chkalovsk
Чудово - chudovo
Чулым - chulym
Чусовой - chusovoy
Чухлома - chukhroma
Шагонар - shagonar
Шадринск - shadrinsk
Шали - shali
Шарыпово - sharypovo
Шарья - sharya
Шатура - shutura
Шахты - shakhty
Шахунья - shahunja
Шацк - shatsk
Шебекино - shebekino
Шелехов - shelekhov
Шенкурск - shenkursk
Шилка - shilka
Шимановск - shimanovsk
Шиханы - shikhany
Шлиссельбург - shlisselburg
Шумерля - shumerlya
Шумиха - shumika
Шуя - shuya
Щёкино - shchokino
Щёлкино - shcholkino
Щёлково - shcholkovo
Щигры - shchigry
Щучье - shchuchye
Электрогорск - elektrgorosk
Электросталь - elektrostal
Электроугли - elektrougli
Элиста - elista
Энгельс - engels
Эртиль - ertil
Югорск - yugorsk
Южа - yuzha
Южно-Сахалинск - yuzhno-sakhalinsk
Южно-Сухокумск - yuzhno-sukhokumsk
Южноуральск - yuzhnouralsk
Юрга - yurga
Юрьев-Польский - yuryev-polsky
Юрьевец - yuryevets
Юрюзань - yuryuzan
Юхнов - yukhno
Ядрин - yadrin
Якутск - yakutsk
Ялта - yalta
Ялуторовск - yalutorovsk
Янаул - yanaul
Яранск - yaransk
Яровое - yarovoye
Ярославль - yaroslavl
Ярцево - yartsevo
Ясногорск - yasnogorsk
Ясный - yasny
Яхрома - yahroma